18 13
1 11
4 3 4 4, 1 6 1 7, 5 5 6 5, 8 5 9 5, 7 8 7 9, 12 11 13 11
5 0, 7 2, 15 4, 4 5, 14 5, 3 8, 15 11, 12 17
000000111111166666
000000111111166666
000000111111166666
000000111111166666
222222333111166666
222222333111166666
222222333111166666
444444333111166666
444444333111166666
444444555555566666
444444555555566666
444444555555566666
444444555555566666